11111111111111111111111111111111
10000000000000000000000000000001
10000000000000000000000000000001
10000000000000000000000000000301
10000000000000000000000000000001
10000000000000000000000000006441
10000000000000000000000000001111
10000000000000000000000000001111
10000000000000000000000000001111
10000000000000000000006444441111
17000006444444444444441111111111
11000001111111111111111111111111
11000001111111111111111111111111
11000001111111111111111111111111
11000001111111111111111111111111
11222221111111111111111111111111
11111111111111111111111111111111
11111111111111111111111111111111
